WE  textures/wall/frosted_ice.xpm 
NO  textures/wall/frosted_ice1.xpm 
SO  textures/wall/frosted_ice2.xpm 
EA  textures/wall/frosted_ice3.xpm

F   76, 78, 79
C   135, 136, 138

DO  textures/door/door1A.xpm
S 141 30 sprites/disco/disco
S   284 60 sprites/boof/boof

111111111111111111111111111111111111111111111111111111111111111111111111
100000001000010000000010000001000000000000000000000000000000000000000001
1000S000100001000000001010000D000000001000000000000000000000000001000001
1000000010000D0000000010000001000000011100000000000000000000000011100001
100000001000010000000010100001000000001000000000000000000000000001000001
100000001000010000000010000001000000000000000000000000000000000000000001
1D11D1111000011D11111110000101000000000000000000000000000000000000000001
101000000000010000000010000001000000000000000000001000000000000000000001
101000000000010000000010100001000000000000000000011100000000000000000001
10111111111111111111D110000001000000000000000000001000000000000000000001
101000000000000000000010000101000000000000000000000000000000000000000001
101000000000000000000010000001000000000000000000000000000000000000000001
101000000000000000000010100001000000100000000000000000000000000000000001
101D11111111111111111110000001000001110000000000000000000000000000000001
101000000000000000000010000101000000100000000000000000000000000000000001
1010000000000000000000D0000001000000000000000000000000000100000000000001
101000000000000000000010100001000000000000000000000000001110000000000001
101111111111111111111111111111000000000000000000000000000100000000000001
100000000000000000000000000001000000000000000000000000000000000000000001
10000000000000000000000000000D000000000000000000000000000000000000000001
100000000000000000000000000001000000000000000000000000000000000000000001
111111111111111111111111111111111111111111111111111111111111111111111111
