WE  textures/wall/eagle.xpm 
NO  textures/wall/greystone.xpm
SO  textures/wall/redbrick.xpm
EA  textures/wall/mossy.xpm

F   62,32,147
C   107,62,179

DO  textures/door/door1A.xpm
S   89 30 sprites/purple_rain/rain

111111111
100000001
100000001
1000N0001
100000001
1111D1111
100000001
100000001
100000001
100000001
1111D1111
100000001
100000001
100000001
100000001
1111D1111
100000001
100000001
100000001
100000001
1111D1111
100000001
100000001
100000001
100000001
1111D1111
100000001
100000001
100000001
111111111




































